GizmoGardenMotors	KEYWORD1
GizmoGardenRotatingMotor	KEYWORD1
getSpeed	KEYWORD2
setSpeed	KEYWORD2
getFullSpeed	KEYWORD2
setFullSpeed	KEYWORD2
GizmoGardenPositioningMotor	KEYWORD1
getOffset	KEYWORD2
setOffset	KEYWORD2
getPosition	KEYWORD2
setPosition	KEYWORD2
GestureKeep	Literal1
GizmoGardenDanceMove	KEYWORD1
GizmoGardenDancer	KEYWORD1
RestMotion	KEYWORD2
MoveStraight	KEYWORD2
TurnLeft	KEYWORD2
TurnRight	KEYWORD2
MoveCustom	KEYWORD2
GestureKeep	Literal1
GizmoGardenGestureAngle	KEYWORD1
GizmoGardenGestures	KEYWORD1
play	KEYWORD2
